password = pwd;
re-password = re-pwd;
hashed password = hhpwd;
new password = npwd;
new username = nuser;
new email = nemail;
username = user;
sexual orientation =  sor;
gender = gen;
hair = hair;
eye color = eye;
height = len;
Personality(array) = pers;
match = mth;
prematch(preference and Personality pref match) = premth;
matchcount = mthc;
like = like;
likecount = likec;
name = name;
lastname = lname;
chat message = chat;
page visits = pvt;
email = email;
Features(array) =  fets;
popularity = pop;
age = age;
search(array) = sch;
race = rc;
preference(array) = pref;
Personality preference(array) = ppref;
errors(array) = err;
profile picture(array) = pric;
location = loco;
distance = dis;
usercount = cuser
verification hash = vhash;